###.................#########
#...###################...#.#
#.####................#.#.#.#
#.###################.#.#.#.#
#.....................#.#.#.#
#####################.#.#.#.#
#...##................#.#.#.#
#.#.##.###.##.#########.#.#.#
#.#....#...##.#.........#.#.#
#.#.##.################.#.#.#
###.##.............####.#.#.#
###.##############.##.#.#.#.#
###.............##....#.#.#.#
######.########.#######.#.#.#
######.####.............#...#
.......######################